[1,1]
██████████████████████
█ ████     ████     ██
█      ███   █  ███ ██
██████ █████ ██████ ██
██████              ██
██   █ █████ █████████
██E    █████ ███   ███
██   ███████     █ ███
██████████████████████